


!                                 !
*********                       *********

                   !
             *************                          !
                                          *********************
                                         ***********************
@                           $           *************************
***************************************************************************
***************************************************************************
***************************************************************************
***************************************************************************


