



                                               $


! $   $                           !   $
*********                       *********

   $               ! $
             *************                     $    !$     $
                                         $*********************
                                         ***********************
@             $                         *************************   $  $
******************************* $ *****************************************
***************************************************************************
***************************************************************************
***************************************************************************