


@                   $                 !         $                             $
****************************************************************       ***   ***
****************************************************************       *** $ ***
****************************************************************       *********
****************************************************************       *********
*
*
*
*
*
* $                  !                                        $             !
*********   ****   **** $ *** ! ******   **** $ ********************************
*********   ********************************************************************
*********   ********************************************************************
*********   ********************************************************************
*********   ********************************************************************





     $             !     $      !       !              $$$$$$$        !      !
********************************************************************************
********************************************************************************
********************************************************************************
********************************************************************************