


@                                     !                                   
****************************************************************       ***   ***
****************************************************************       *** $ ***
****************************************************************       *********
****************************************************************       *********
*
*
*
*
*
* $                                                                       !
*********   ****   ****   ***   ******   ****   ********************************
********************************************************************************
********************************************************************************
********************************************************************************
********************************************************************************