


!    $                            !
*********                       *********

                   !
             *************                          !$
                                          *********************
                                         ***********************
@             $                         *************************
***************************************************************************
***************************************************************************
***************************************************************************
***************************************************************************


