


!      $                           ! 
*********                       **********					
                                          **                **      
         *****                              ** $          **			$
                   !                          **        **       ********* 
             ************                       **    **
                                           					
                                                      
@                                       			!	 				
***************************************************************************
***************************************************************************
***************************************************************************
***************************************************************************


